X X X X X X X X X X X X X X X X X X X X X X X X X X X X
X X X X X X X X X X X X X X X X X X X X X X X X X X X X
X X X X X X X X X X X X X X X X X X X X X X X X X X X X
0 1 1 1 1 1 1 1 1 1 1 1 1 7 8 1 1 1 1 1 1 1 1 1 1 1 1 0
1 + . . . . + . . . . . + 3 3 + . . . . . + . . . . + 1
1 . 2 3 3 2 . 2 3 3 3 2 . 3 3 . 2 3 3 3 2 . 2 3 3 2 . 1
1 p 3 X X 3 . 3 X X X 3 . 3 3 . 3 X X X 3 . 3 X X 3 p 1
1 . 2 3 3 2 . 2 3 3 3 2 . 2 2 . 2 3 3 3 2 . 2 3 3 2 . 1
1 + . . . . + . . + . . + . . + . . + . . + . . . . + 1
1 . 2 3 3 2 . 2 2 . 2 3 3 3 3 3 3 2 . 2 2 . 2 3 3 2 . 1
1 . 2 3 3 2 . 3 3 . 2 3 3 9 9 3 3 2 . 3 3 . 2 3 3 2 . 1
1 + . . . . + 3 3 + . . + 3 3 + . . + 3 3 + . . . . + 1
0 1 1 1 1 6 . 3 9 3 3 2 . 3 3 . 2 3 3 9 3 . 6 1 1 1 1 0
X X X X X 1 . 3 9 3 3 2 . 2 2 . 2 3 3 9 3 . 1 X X X X X
X X X X X 1 . 3 3 d - - U - - U - - d 3 3 . 1 X X X X X
X X X X X 1 . 3 3 - 4 5 5 = = 5 5 4 - 3 3 . 1 X X X X X
1 1 1 1 1 6 . 2 2 - 5 X X X X X X 5 - 2 2 . 6 1 1 1 1 1
n - - - - - + - - d 5 X X X X X X 5 d . . + - - - - - n
1 1 1 1 1 6 . 2 2 - 5 X X X X X X 5 - 2 2 . 6 1 1 1 1 1
X X X X X 1 . 3 3 - 4 5 5 5 5 5 5 4 - 3 3 . 1 X X X X X
X X X X X 1 . 3 3 d - - - - - - - - d 3 3 . 1 X X X X X
X X X X X 1 . 3 3 - 2 3 3 3 3 3 3 2 . 3 3 . 1 X X X X X
0 1 1 1 1 6 . 2 2 - 2 3 3 9 9 3 3 2 . 2 2 . 6 1 1 1 1 0
1 + . . . . + . . + . . + 3 3 + . . + . . + . . . . + 1
1 . 2 3 3 2 . 2 3 3 3 2 . 3 3 . 2 3 3 3 2 . 2 3 3 2 . 1
1 . 2 3 9 3 . 2 3 3 3 2 . 2 2 . 2 3 3 3 2 . 3 9 3 2 . 1
1 p . + 3 3 + . . + . . u - - u . . + . . + 3 3 + . p 1
8 3 2 . 3 3 . 2 2 . 2 3 3 3 3 3 3 2 . 2 2 . 3 3 . 2 3 7
7 3 2 . 2 2 . 3 3 . 2 3 3 9 9 3 3 2 . 3 3 . 2 2 . 2 3 8
1 + . + . . + 3 3 + . . + 3 3 + . . + 3 3 + . . + . + 1
1 . 2 3 3 3 3 9 9 3 3 2 . 3 3 . 2 3 3 9 9 3 3 3 3 2 . 1
1 . 2 3 3 3 3 3 3 3 3 2 . 2 2 . 2 3 3 3 3 3 3 3 3 2 . 1
1 + . . . . . . . . . . + . . + . . . . . . . . . . + 1
0 1 1 1 1 1 1 1 1 1 1 1 1 1 1 1 1 1 1 1 1 1 1 1 1 1 1 0
X X X X X X X X X X X X X X X X X X X X X X X X X X X X
X X X X X X X X X X X X X X X X X X X X X X X X X X X X